#####################
##........#........##
##o##.###.#.###.##o##
##.................##
##.##.#.#####.#.##.##
##....#...#...#....##
#####.### # ###.#####
#####.....0.....#####
#####.# ## ## #.#####
     .  #123#  .     
#####.# ##### #.#####
#####.# ..... #.#####
#####.# ##### #.#####
##........#........##
##.##.###.#.###.##.##
##o.#...........#.o##
###.#.#.#####.#.#.###
##....#...#...#....##
##.######.#.######.##
##.................##
#####################