#####################
##........#........##
##o##.###.#.###.##o##
##.................##
##.##.#.#####.#.##.##
##....#...#...#....##
#####.### # ###.#####
#####.....0.12.3#####
#####.# ##=## #.#####
     .  #...#  .     
#####.# ##### #.#####
#####.# ..... #.#####
#####.# ##### #.#####
##........#........##
##.##.###.#.###.##.##
##o.#.....P.....#.o##
###.#.#.#####.#.#.###
##....#...#...#....##
##.######.#.######.##
##.................##
#####################
