#####################
##........#........##
##o##.###.#.###.##o##
##.................##
##.##.#.#####.#.##.##
##....#...#...#....##
#####.### # ###.#####
#####...........#####
#####.# ##4## #.#####
     .  #123#  .     
#####.# ##### #.#####
#####.# ..... #.#####
#####.# ##### #.#####
##........#........##
##.##.###.#.###.##.##
##o.#.....0.....#.o##
###.#.#.#####.#.#.###
##....#...#...#....##
##.######.#.######.##
##.................##
#####################